01,01,01,01,04,00,00,00,00,00,00,00,00,00,00,00,00,00,00,00,00,03,01,01,01
01,01,01,21,11,00,00,00,00,00,00,00,00,00,00,00,00,00,00,00,00,06,16,01,01
01,01,21,11,00,00,00,00,00,00,00,00,00,00,00,00,00,00,00,00,00,00,06,16,01
02,02,11,00,00,00,00,00,07,05,05,05,05,05,05,05,05,10,00,00,00,00,00,06,02
00,00,00,00,00,00,00,00,03,01,01,01,01,01,01,01,01,04,00,00,00,00,00,00,00
00,00,00,00,00,00,00,00,03,01,01,01,01,01,01,01,01,04,00,00,00,00,00,00,00
00,00,00,00,00,00,00,00,03,01,01,01,01,01,01,01,01,04,00,00,00,00,00,00,00
00,00,00,00,07,05,05,05,15,01,01,01,01,01,01,01,01,04,00,00,00,00,00,00,00
00,00,00,00,03,01,01,01,01,01,01,01,01,01,01,01,01,04,00,00,00,00,00,00,00
00,00,00,00,03,01,01,01,01,01,01,01,01,01,01,01,01,20,05,05,10,00,00,00,00
00,00,00,00,03,01,01,01,01,01,01,01,01,01,01,01,01,01,01,01,04,00,00,00,00
00,00,00,00,03,01,01,01,01,01,01,01,01,01,01,01,01,01,01,01,04,00,00,00,00
00,00,00,00,03,01,01,01,01,01,01,01,01,21,02,16,01,01,01,01,04,00,00,00,00
00,00,00,00,03,01,01,01,01,01,01,01,01,04,00,03,01,01,01,01,04,00,00,00,00
00,00,00,00,03,01,01,01,01,01,01,01,01,04,00,06,02,02,02,02,11,00,00,00,00
00,00,00,00,03,01,01,01,01,01,01,01,01,04,00,00,00,00,00,00,00,00,00,07,05
00,00,00,00,06,02,02,02,02,02,02,02,02,11,00,00,00,00,00,00,00,00,00,03,01
00,00,00,00,00,00,00,00,00,00,00,00,00,00,00,00,00,00,00,00,00,00,07,15,01
05,10,00,00,00,00,00,00,00,00,00,00,00,00,00,00,00,00,00,00,07,05,15,01,01
01,04,00,00,00,00,00,00,00,00,00,00,00,00,00,00,00,00,00,00,03,01,01,01,01

1,1,1,1,1,1,1,1,1,1,1,1,1,1,1,1,1,1,1,1,1,1,1,1,1
1,0,0,0,0,0,0,0,0,0,0,0,0,0,0,0,0,0,0,0,0,0,0,0,1
1,0,0,0,0,0,0,0,0,0,0,0,0,0,0,0,0,0,0,0,0,0,0,0,1
1,0,0,0,0,0,0,0,0,0,0,0,0,0,0,0,0,0,0,0,0,0,0,0,1
1,0,0,0,0,0,0,0,0,0,0,0,0,0,0,0,0,0,0,0,0,0,0,0,1
1,0,0,0,0,0,0,0,0,0,0,0,0,0,0,0,0,0,0,0,0,0,0,0,1
1,0,0,0,0,0,0,0,0,0,0,0,0,0,0,0,0,0,0,0,0,0,0,0,1
1,0,0,0,0,0,0,0,0,0,0,0,0,0,0,0,0,0,0,0,0,0,0,0,1
1,0,0,0,0,0,0,0,0,0,0,0,0,0,0,0,0,0,0,0,0,0,0,0,1
1,0,0,0,0,0,0,0,0,0,0,0,0,0,0,0,0,0,0,0,0,0,0,0,1
1,0,0,0,0,0,0,0,0,0,0,0,0,0,0,0,0,0,0,0,0,0,0,0,1
1,0,0,0,0,0,0,0,0,0,0,0,0,0,0,0,0,0,0,0,0,0,0,0,1
1,0,0,0,0,0,0,0,0,0,0,0,0,0,0,0,0,0,0,0,0,0,0,0,1
1,0,0,0,0,0,0,0,0,0,0,0,0,0,0,0,0,0,0,0,0,0,0,0,1
1,0,0,0,0,0,0,0,0,0,0,0,0,0,0,0,0,0,0,0,0,0,0,0,1
1,0,0,0,0,0,0,0,0,0,0,0,0,0,0,0,0,0,0,0,0,0,0,0,1
1,0,0,0,0,0,0,0,0,0,0,0,0,0,0,0,0,0,0,0,0,0,0,0,1
1,0,0,0,0,0,0,0,0,0,0,0,0,0,0,0,0,0,0,0,0,0,0,0,1
1,0,0,0,0,0,0,0,0,0,0,0,0,0,0,0,0,0,0,0,0,0,0,0,1
1,1,1,1,1,1,1,1,1,1,1,1,1,1,1,1,1,1,1,1,1,1,1,1,1

0,0,0,0,0,0,0,0,0,0,0,0,0,0,0,0,0,0,0,0,0,0,0,0,0
0,0,0,0,0,0,0,0,0,0,0,0,0,0,0,0,0,0,0,0,0,0,0,0,0
0,0,0,0,0,0,0,0,0,0,0,0,0,0,0,0,0,0,0,0,0,0,0,0,0
0,0,0,0,0,0,0,0,1,1,1,1,1,1,1,1,1,1,0,0,0,0,0,0,0
0,0,0,0,0,0,0,0,1,0,0,0,0,0,0,0,0,1,0,0,0,0,0,0,0
0,0,0,0,0,0,0,0,1,0,0,0,0,0,0,0,0,1,0,0,0,0,0,0,0
0,0,0,0,0,0,0,0,1,0,0,0,0,0,0,0,0,1,0,0,0,0,0,0,0
0,0,0,0,1,1,1,1,1,0,0,0,0,0,0,0,0,1,0,0,0,0,0,0,0
0,0,0,0,1,0,0,0,0,0,0,0,0,0,0,0,0,1,0,0,0,0,0,0,0
0,0,0,0,1,0,0,0,0,0,0,0,0,0,0,0,0,1,1,1,1,0,0,0,0
0,0,0,0,1,0,0,0,0,0,0,0,0,0,0,0,0,0,0,0,1,0,0,0,0
0,0,0,0,1,0,0,0,0,0,0,0,0,0,0,0,0,0,0,0,1,0,0,0,0
0,0,0,0,1,0,0,0,0,0,0,0,0,1,1,1,0,0,0,0,1,0,0,0,0
0,0,0,0,1,0,0,0,0,0,0,0,0,1,0,1,0,0,0,0,1,0,0,0,0
0,0,0,0,1,0,0,0,0,0,0,0,0,1,0,1,1,1,1,1,1,0,0,0,0
0,0,0,0,1,0,0,0,0,0,0,0,0,1,0,0,0,0,0,0,0,0,0,0,0
0,0,0,0,1,1,1,1,1,1,1,1,1,1,0,0,0,0,0,0,0,0,0,0,0
0,0,0,0,0,0,0,0,0,0,0,0,0,0,0,0,0,0,0,0,0,0,0,0,0
0,0,0,0,0,0,0,0,0,0,0,0,0,0,0,0,0,0,0,0,0,0,0,0,0
0,0,0,0,0,0,0,0,0,0,0,0,0,0,0,0,0,0,0,0,0,0,0,0,0
